A
Ab - od
Der Abend - veče
Aber - ali
Acht - osam
Ähnlich - slično
Die Ahnung - ideja, misao
Allein - sam
Alles - sve
Alt - staro
Der Apfel - jabuka
Der Apfelsaft
Die Angst - strah
Die Antwort - odgovor
Die Apotheke - apoteka
Die Arbeit - posao
Arbeiten, arbeitest, arbeitet - raditi
Der Arbeitgeber - poslodavac
Der Arbeitnehmer - zaposleni
Der Arzt - doktor
Das Auge - oko
Der Aufzug - lift
Außer - osim
Ausgang - izlaz
Auskommen - doći iz
Ausnahme - izuzetak
Aussehen - izgledati
Das Auto - auto
Alt, älter - star, stariji

B
Die Bäckerei - pekara
Die Bahn - voz
Der Bahnhof - železnička stanica
Der Balkon - balkon
Der Ball - lopta
Die Banane - banana
Die Bank - banka
Der Bär - medved
Bauen - graditi
Der Bauer - seljak, zemljoradnik
Der Baum - drvo
Beginnen - početi
Bei - pored
Das Bein - noga
Benutzen - koristiti
Der Berg - planina
Der Beruf - struka
Besitzen - posedovati, imati
Besonders - posebno
Der Besuch - poseta
Das Besucher - posetitelj
Beste - najbolje
Das Beton - beton
Das Bett - krevet
Bezahlen - platiti
Die Beziehung - veza, odnos
Die Bibliothek - biblioteka
Das Bier - pivo
Die Biene - pčela
Das Bild - slika
Billig - jeftino
Bin, bist, ist, sind, seit, sind - biti
Bis - do
Bitte - molim
Blau - plavo
Bleiben - biti, postojati
Die Blume - cvet
Das Boot - brod, čamac
Brauchen - trebati
Braun - braon
Die Brille - naočare
Bringen - doneti
Die Brücke - most
Die Brust - grudi
Das Buch - knjiga
Bunt - šareno
Der Bürgermeister - gradonačelnik
Der Bus - autobus
Die Butter - puter

C
Der Chef - šef
Der Computer - kompjuter

D
Da - zato što (since), tu
Das Dach - krov
Danken - zahvaliti
Dann - onda
Denken - mislit
Denn - zbog toga, zato
Doch - već
Der Dorf - selo
Drei - tri
Drücken - grliti
Du - ti
Dunkel - tamno
Durch - kroz
Durstig - žedan
Das Dutzend - tuce, 12

E
Die Ecke - ćošak, ugao
Das ei - jaje
Ein - jedan
Einfach - lako, jednostavno
Der Eingang - ulaz
Das Einkaufszentrum - tržni centar
Einkaufen - kupovati, shopping
Einschließlich - uključujući
Das Eis - led, sladoled
Das Eisen - gvožđe
Elf - jedanaest
Die Eltern - deda i baba
Das Ende - kraj
Der Enkel - unuk
Die Ente - patka
Entschuldigung - Izvini
Entweder - ili (prvo ili u ili...ili - either)
Er - on
Die Erde - zemlja
Die Erdbeere - jagoda
Die Erfahrung - iskustvo
Es - to
Essen - jesti
Das Essen - hrana

F
Das Fahrrad - bicikl
Die Fähre - trajekt
Fahren - voziti
Die Familie - porodica
Die Farbe - boja
Das Fenster - prozor
Die Ferien - praznici
Fernsehen - gledati tv
Der fernseher - tv
Fertig - spremno, gotovo
Das Feuer - vatra
Das Feuerzeug - upaljač
Fier - četiri
Finden - naći
Der Finger - prst
Der Fisch - riba
Der Fleck - tufna, mrlja, fleka
Die Fliege - muva
Fliegen - leteti
Das Flugzeug - avion
Folgen - pratiti
Der Forscher - naučnik/istraživač
Die Frage - pitanje
Fragen - pitati
Die Frau - žena
Der Freund - prijatelj
Froh - srećan
Früh - rano
Das Frühstück - doručak
Die Fotographie - fotografija
Der Fuß - noga
Der Fußball - fudbal
Fünf - pet

G
Die Gabel - viljuška
Der Garten - dvorište
Das Gebäude - zgrada
Geben - davati
Gegen - oko, prema, ka, protiv
Das Gegner - protivnik, neprijatelj
Gehen - ići
Gelb - žuto
Das Geld - pare
Der Geldautomaten - bankomat
Das Gemüse - povrće
Genau - tako je, slažem se
Genug - dosta
Gern - rado
Gern gestehen - nema na čemu
Das Geschäft - radnja
Der Geschäftsführer - menadžer, direktor
Das Geschenk - poklon
Das Geschlecht - rod/pol
Das Gesicht - lice
Gestern - juče
Das Getränk - piće
Das Glas - čaša
Gleich - isto
Das Gleis - peron
Das Glück - sreća
Das Gold - zlato
Grau - sivo
Groß - veliko
Die Gruppe - grupa
Grün - zeleno
Gut - dobro
Das Gutschein - vaučer

H
Das Haar - kosa
Die Hälfte - polovina
Hallo - zdravo
Haben - imati
Der Hals - vrat
Das Hähnchen - pile
Die Hand - ruka
Der Händler - trgovac
Die Handschuhe - rukavica
Das Handy - mobilni
Haupt - glavni
Das Haus - kuća
Die Haut - koža
Heisen - zvati se
Heiß - vruće
Hell - svetlo
Das Herz - srce
Heute - danas
Das Hemd - košulja
Hilfen - pomagati
Der Himmel - nebo
Hoch - visoko
Die Hochzeit - venčanje
Die Hochzeitsreise - medeni mesec
Das Holz - drvo (materijal)
Der Hönig - med
Hören - slušati
Die Hose - pantalone
Das Hotel - hotel
Der Hund - pas
Der Hut - kapa

I
Ich - ja
Die Idee - ideja
Igritt - bljak
Ihr - vi
Immer - uvek
Das Internet - internet
Irgendwo - negde
Irgendwann - nekad
Irgendwas - nešto
Irgendwer - neko
Irgendwie - nekako

J
Ja - da
Die Jacke - jakna
Jemand - bilo ko
Jetzt - sada
Der Job - posao
Jung - mlad
Der Junge - dečak

K
Der Kaffee - kafa
Kalt - hladno
Der Käse - sir
Die Kasse - kasa, blagajna
Die Katze - mačka
Die Kartoffel - krompir
Die Karte - mapa
Kaufen - kupovati
Kaum - jedva
Der Keller - podrum
Kennen - umeti, znati
Kennenlernen - upoznati
Das Kind - dete
Die Kirche - crkva
Klar - jasno, providno
Das Kleid - haljina
Klein - malo
Die Kleidung - odeća
Der Koch - kuvar
Kochen - kuvati
Kommen - doći
Der Knoblauch - beli luk
Der Knopf - dugme
Der König - kranj
Der Kopf - glava
Der Körper - telo
Die Kosmetik - kozmetika
Kosten - koštati
Kranken - bolestan
Das Krankenhaus - bolnica
Krankenschwester - medicinska sestra
Die Küche - kuhinja
Der Kuchen - kolač
Die Kuh - krava
Der Kühlschrank - frižider
Das Kupfer - bakar
Kurz - kratko

L
Das Ladegerät - punjač
Der Laden - radnja
Die Lampe - lampa
Das Land - država
Lange - dugačak
Langsam - sporo
Langweilig - dosadno
Laufen - trčati
Laut - glasno
Die Leute - ljudi
Leben - živeti
Lecker - ukusno
Das Leder - koža (materijal)
Legen - stavljati, spuštati (put)
Leider - nažalost
Lernen - učiti
Der Lehrer - učitelj
Lesen - čitati
Die Liebe - ljubav
Lieben - voleti
Die Linde - lipa
Der Löffel - kašika
Die Luft - vazduh
Lustig - smešan

M
Machen - praviti
Das Mädchen - devojčica
Der Magen - stomak
Der Mann - čovek
Der Mantel - kaput
Der Markt - prodavnica
Die Marmelade - džem, marmelada
Die Mauer - zid
Die Maus - miš
Das Meer - more
Mehr - više
Mein - moje
Das Messer - nož
Die Milch - mleko
Die Milliarde - milijardu
Der Mitarbeiter - kolega
Das Mitglied - član
Das Mittagessen - ručak
Mögen - voleti
Der Mond - mesec
Morgen - sutra
Der Morgen - jutro
Der Motor - motor
Das Motorrad - motocikl
Müde - umorno
Der Mund - usta
Die Musik - muzika
Die Mutter - mama

N
Nach - prema
Die Nacht - noć
Der Nachtisch - dezert
Nah - blizu
Die Nase - nos
Die Natur - priroda
Natürlich - naravno
Neben - pored
Nehmen - uzeti, naručiti
Der Neffe - nećak
Nein - ne
Neue - novo
Neun - devet
Nichts - bez, nije
Die Nichte - nećakinja
Nie - nikad
Niemals - nikad
Nieman - niko
nirgends/nirgendwo - nigde
Noch - još uvek
Nord - sever
Die Nudeln - pasta, testenina
Die Nummer - broj
Die Nuss - the nut

O
Das Obst - voće
Obwohl - iako
Ohne - bez
Die Oma - baba
Der Onkel - ujak
Der Opa - deda
Die Orange - pomorandža
Die Ordnung - red
Der Ort - mesto
Ost - istok

P
Der Park - park
Der Partner - partner
Die Partnerschaft - partnerstvo
Passen - odgovara
Perfekt - savršeno
Die Pfanne - tiganj
Der Pfannkuchen - palačinka
Das Pferd - konj
Der Pilz - pečurka
Pink - roze
Die Pizza - pizza
Der Plan - plan
Das Plastik - plastika
Die Polizei - policija
Der Polizist - policajac
Die Pommes - pomfrit
Der Preis - nagrada
Die Preise - cena
Putzen - čistiti

R
Das Radio
Rauchen - pušiti
Das Regal - polica
Reich - bogat
Reicht - dovoljno
Der Reis - pirinač
Die Reise - putovanje
Reisen - putovati
Das Restaurant - restoran
Das Rezept
Der Ring - prsten
Der Rock - suknja
Rot - crveno
Der Rücken - leđa
Der Rücksack - ranac
Rufen - zvati
Ruhig - mirno
Rund - okruglo

S
Der Saft - sok
Sagen - reći
Der Salat - salata
Das Salz - so
Salzig - slano
Der Sand - pesak
Der Satz - rečenica
Sauber - čisto
Sauer - kiselo
Schade - loše
Scharf - ljut (ukus), oštar
Schlagen - udarati, tući
Das Schloss - zamak
Der Schinken - šunka
Schlafen - spavat
Schlecht - loše
Der Schlüssel - ključ
Schmecken - imati ukus
Schmutzig - prljavo
Der Schnee - sneg
Schnell - brzo
Schön - dobro
Der Schrank - ormar
Schreiben - pisati
Der Schuh - cipela
Die Schule - škola
Die Schulter - rame
Schwah - lako
Schwanger - trudna
Schwarz - crno
Das Schwein - svinja
Schwer/ig - teško
Der See - jezero
Sehen - videti
Seit - od (vremenski)
Der Senf - senf
Sicher - sigurno
Die Sicherheit - sigurnost
Sie - ona, oni
Sieben - sedam
Das Silber - srebro
Sobald - čim
Das Sofa - kauč
Der Sohn - sin
Sollten - treba
Der Sommer - leto
Sondern - ali, nego
Die Sonne - sunce
Der Spaß - zabava
Die Speisekarte - meni, jelovnik
Das Spielzeug - igračka
Spielen - igrati se
Die Spinne - pauk
Sprachen - govoriti
Die Stadt - grad
Der Stahl - čelik
Stark - jak
Die Steckdose - šteker
Stehen - stajati
Der Stein - kamen
Der Stern - zvezda
Die Straße - ulica
Der Strand - plaža
Die Strecke - prolaz
Das Stück - komad
Der Student
Der Stuhl - stolica
Die Stunde - čas
Suchen - tražiti
Süd - južno
Die Summe - suma
Süß - slatko

T
Der Tag - dan
Die Tante - tetka
Tanzen - igrati/plesati
Die Tasche - torba
Der Tee - čaj
Die Telefonnummer - broj telefona
Das Teppich - tepih
Teuer - skupo
Tief - duboko
Der Tisch - stol
Die Tochter - ćerka
Die Tomate - paradajz
Die Tör - kapija
Traurig - tužan
Die Treppe - stepenice
Trinken - piti
Das Trinkgeld - bakšiš
Tun - raditi (eng. do)
Die Tür - vrata
Die Tüte - kesa

U
Über - preko
Die Überraschung - iznenadjenje
Überweisen - prebacivati pare
Um - okolo, u (tačno vreme)
Die Universität - univerzitet
Unter - ispod

V
Der Vater - otac
Vergessen - zaboraviti
Verheiratet - oženjen
Verkaufen - prodavati
Verloren - izgubljen, izgubiti se
Verstehen - razumeti
Der Vogel - ptica
Von - od
Die Vorspeise - predjelo

W
Während - dok
Die Wand - zid
Warm - toplo
Warum - zašto
Waschen - prati
Das Wasser - voda
Der Weg - put, način, metod
Weil - zato što
Der Wein - vino
Weit - daleko
Welche - koji
Die Welt - svet
Die WerkStatt - radionica
Das Werkzeug - alat
West - zapad
Wichtig - bitan
Wie - kako
Wieder - opet, natrag, ponovo, još
Der Wind - vetar
Winnen - osvojiti, pobediti
Der Winter - zima
Wissen - znati, shvatiti
Die Wissenschaft - nauka
Woher - odakle
Wo, wohin - gde
Die Wolle - vuna
Wollen - želeti
Wonach - kuda
Wohnen - stanovati
Die Wohnung - stan
Das Wort - reč
Die Wurst - kobasica

Z
Die Zahl - cifra, broj
Zahlen - brojati
Der Zahn - zub
Der Zaun - ograda
Zehn - deset
Zeigen - pokazivati
Die Zeit - vreme
Die Zeitung - novine
Das Zimmer - soba
Die Zitrone - limun
Der Zoll - carina
Der Zucker - šećer
Zusammen - zajedno
Zwei - dva
Die Zwiebel - crni luk
Die Zwillinge - blizanci
Zwischen - između
Zwölf - dvanaest
